SET en
SUBSET normal
20 25
0 0 0
| Esc |  1  |  2  |  3  |  4  |  5  |Home |-----| End |  6  |  7  |  8  |  9  |  0  |  -  |
|  =  |  Q  |  W  |  E  |  R  |  T  |  /  |-----|  .  |  Y  |  U  |  I  |  O  |  P  |  \  |
| Prt |  A  |  S  |  D  |  F  |  G  |  \  |-----|  ,  |  H  |  J  |  K  |  L  |  {  |  '  |
|  ⇧  |  Z  |  X  |  C  |  V  |  B  |-----------------|  N  |  M  |  [  |  ]  |  /  |  ⇧  |
|     |LCtrl|LAlt |  ◀  |  ▶  |-----------------------------|  ▲  |  ▼  |  ,  |  .  |     |

------------------------| Win |-----------------------------|  ⏎  |------------------------
------------------------|  ⎵  | Tab |     |-----|     | Del |  ⌫  |------------------------

SUBSET shifted
30 10
0 0 0
|     |  !  |  @  |  #  |  $  |  %  |     |-----|     |  ^  |  &  |  *  |  (  |  )  |  _  |
|  +  |     |     |     |     |     |     |-----|  :  |     |     |     |     |     |  |  |
|     |     |     |     |     |     |     |-----|  ;  |     |     |     |     |  }  |  "  |
|     |     |     |     |     |     |-----------------|     |     |  <  |  >  |  ?  |     |
|     |     |     |     |     |-----------------------------|     |     |  ;  |  :  |     |

------------------------|     |-----------------------------|     |------------------------
------------------------|     |     |     |-----|     |     |     |------------------------

SUBSET held
5 38
30 40 130
|     |     |     |     |     |     |     |-----|     |     |     |     |     |     |     |
|     |     |     |     |     |     |     |-----|     |     |     |     |     |     |     |
|     |     |     |     |     |     |     |-----|     |     |     |     |     |     |     |
|     |     |     |     |     |     |-----------------|     |     |     |     |     |     |
|  ⟲1 |     |     |     |     |-----------------------------|     |     |     |     |  ⟲1 |

------------------------|     |-----------------------------|     |------------------------
------------------------|     |     |  ⟲1 |-----| ⟲2  |     |     |------------------------

SUBSET symbols
10 2
220 128 0
|     | F1  | F2  | F3  | F4  | F5  |     |-----|     | F6  | F7  | F8  | F9  | F10 | F11 |
|     |  !  |  @  |  {  |  }  |  |  |     |-----|     |PgUp |Home |  ▲  | End |  *  | F12 |
|     |  #  |  $  |  (  |  )  |  `  |     |-----|     |PgDn |  ◀  |  ▼  |  ▶  |  +  | Ins |
|Caps |  %  |  ^  |  [  |  ]  |  ~  |-----------------|  &  |  1  |  2  |  3  |  \  |     |
|     |  ,  | Red |Green|Blue |-----------------------------|     |  .  |  0  |  =  |     |

------------------------|Anim |-----------------------------|ON/OF|------------------------
------------------------| Br▼ | Br▲ |Auto |-----|  ⏸  |Hue▼ |Hue▲ |------------------------
END


SET ru:en
SUBSET normal
20 25
0 0 0
|     |     |     |     |     |     |     |-----|     |     |     |     |     |     |     |
|     |  Й  |  Ц  |  У  |  К  |  Е  |     |-----|     |  Н  |  Г  |  Ш  |  Щ  |  З  |  Х  |
|     |  Ф  |  Ы  |  В  |  А  |  П  |     |-----|     |  Р  |  О  |  Л  |  Д  |  Ж  |  Э  |
|     |  Я  |  Ч  |  С  |  М  |  И  |-----------------|  Т  |  Ь  |  Б  |  Ю  |  Ъ  |     |
|     |     |     |     |     |-----------------------------|     |     |  ,  |  .  |     |

------------------------|     |-----------------------------|     |------------------------
------------------------|     |     |     |-----|     |     |     |------------------------

SUBSET shifted
30 10
0 0 0
|     |  !  |  "  |  №  |  ;  |  %  |     |-----|     |  :  |  ?  |  *  |  (  |  )  |     |
|     |     |     |     |     |     |     |-----|     |     |     |     |     |     |  Х  |
|     |     |     |     |     |     |     |-----|     |     |     |     |     |  Ж  |  Э  |
|     |     |     |     |     |     |-----------------|     |     |  Б  |  Ю  |  Ъ  |     |
|     |     |     |     |     |-----------------------------|     |     |  ;  |  :  |     |

------------------------|     |-----------------------------|     |------------------------
------------------------|     |     |     |-----|     |     |     |------------------------
END